Period,Inventory,Arrived,Available,Needed,Succeeded,Failed,Lost
1,0,0,0,0,0,0,0
2,0,100,100,0,0,0,0
3,100,0,100,5,5,0,0
4,95,0,95,6,6,0,0
5,89,8,97,5,5,0,0
6,92,9,101,9,9,0,0
7,92,5,97,6,6,0,0
8,91,11,102,7,7,0,0
9,95,6,101,25,25,0,0
10,76,7,83,32,32,0,0
11,51,34,85,134,85,49,0
12,0,42,42,377,42,335,0
13,0,144,144,581,144,437,0
14,0,207,207,534,207,327,0
15,0,347,347,465,347,118,0
16,0,283,283,519,283,236,0
17,0,326,326,461,326,135,0
18,0,291,291,332,291,41,0
19,0,310,310,274,274,0,0
20,36,263,299,214,214,0,0
21,85,246,331,230,230,0,0
22,101,174,275,158,158,0,0
23,117,188,305,122,122,0,0
24,183,109,292,70,70,0,0
25,222,71,293,55,55,0,0
26,238,16,254,47,47,0,0
27,207,12,219,46,46,0,0
28,173,14,187,47,47,0,0
29,140,19,159,40,40,0,0
30,119,24,143,49,49,0,0
31,94,22,116,32,32,0,0
32,84,39,123,20,20,0,0
33,103,24,127,39,39,0,0
34,88,14,102,48,48,0,0
35,54,38,92,41,41,0,0
36,51,52,103,47,47,0,0
37,56,41,97,71,71,0,0
38,26,49,75,129,75,54,0
39,0,84,84,156,84,72,0
40,0,115,115,196,115,81,0
41,0,121,121,207,121,86,0
42,0,153,153,218,153,65,0
43,0,144,144,253,144,109,0
44,0,168,168,293,168,125,0
45,0,168,168,405,168,237,0
46,0,202,202,399,202,197,0
47,0,246,246,464,246,218,0
48,0,241,241,514,241,273,0
49,0,294,294,572,294,278,0
50,0,288,288,625,288,337,0
51,0,351,351,733,351,382,0
52,0,342,342,818,342,476,0
53,0,434,434,940,434,506,0
54,0,431,431,806,431,375,0
55,0,541,541,757,541,216,0
56,0,416,416,565,416,149,0
57,0,513,513,518,513,5,0
58,0,360,360,434,360,74,0
59,0,472,472,383,383,0,0
60,89,318,407,391,391,0,0
61,16,322,338,386,338,48,0
62,0,324,324,459,324,135,0
63,0,274,274,553,274,279,0
64,0,292,292,669,292,377,0
65,0,308,308,899,308,591,0
66,0,395,395,1229,395,834,0
67,0,482,482,1511,482,1029,0
68,0,663,663,1380,663,717,0
69,0,773,773,1197,773,424,0
70,0,731,731,998,731,267,0
71,0,704,704,739,704,35,0
72,0,651,651,625,625,0,0
73,26,613,639,408,408,0,0
74,231,545,776,320,320,0,0
75,456,299,755,255,255,0,0
76,500,172,672,190,190,0,0
77,482,96,578,160,160,0,0
78,418,46,464,117,117,0,0
79,347,41,388,103,103,0,0
80,285,20,305,80,80,0,0
81,225,32,257,63,63,0,0
82,194,26,220,55,55,0,0
83,165,24,189,93,93,0,0
84,96,26,122,112,112,0,0
85,10,79,89,179,89,90,0
86,0,114,114,224,114,110,0
87,0,132,132,261,132,129,0
88,0,163,163,226,163,63,0
89,0,176,176,213,176,37,0
90,0,162,162,212,162,50,0
91,0,169,169,180,169,11,0
92,0,158,158,178,158,20,0
93,0,161,161,164,161,3,0
94,0,152,152,164,152,12,0
95,0,153,153,125,125,0,0
96,28,141,169,170,169,1,0
97,0,110,110,205,110,95,0
98,0,163,163,199,163,36,0
99,0,124,124,206,124,82,0
100,0,174,174,238,174,64,0
101,0,130,130,280,130,150,0
102,0,193,193,317,193,124,0
103,0,164,164,405,164,241,0
104,0,231,231,953,231,722,0
105,0,228,228,1542,228,1314,0
106,0,558,558,1890,558,1332,0
107,0,737,737,1769,737,1032,0
108,0,1013,1013,1240,1013,227,0
109,0,867,867,910,867,43,0
110,0,832,832,633,633,0,0
111,199,715,914,467,467,0,0
112,447,490,937,387,387,0,0
113,550,347,897,355,355,0,0
114,542,243,785,340,340,0,0
115,445,161,606,352,352,0,0
116,254,150,404,432,404,28,0
117,0,212,212,526,212,314,0
118,0,338,338,685,338,347,0
119,0,234,234,810,234,576,0
120,0,465,465,783,465,318,0
121,0,366,366,658,366,292,0
122,0,514,514,566,514,52,0
123,0,325,325,445,325,120,0
124,0,472,472,409,409,0,0
125,63,281,344,283,283,0,0
126,61,373,434,247,247,0,0
127,187,229,416,209,209,0,0
128,207,176,383,221,221,0,0
129,162,131,293,279,279,0,0
130,14,156,170,374,170,204,0
131,0,239,239,458,239,219,0
132,0,191,191,639,191,448,0
133,0,316,316,618,316,302,0
134,0,328,328,550,328,222,0
135,0,376,376,553,376,177,0
136,0,313,313,459,313,146,0
137,0,366,366,548,366,182,0
138,0,288,288,469,288,181,0
139,0,366,366,478,366,112,0
140,0,275,275,459,275,184,0
141,0,353,353,428,353,75,0
142,0,254,254,521,254,267,0
143,0,333,333,574,333,241,0
144,0,261,261,612,261,351,0
145,0,377,377,757,377,380,0
146,0,311,311,697,311,386,0
147,0,474,474,690,474,216,0
148,0,332,332,660,332,328,0
149,0,470,470,535,470,65,0
150,0,321,321,403,321,82,0
151,0,440,440,415,415,0,0
152,25,282,307,387,307,80,0
153,0,383,383,385,383,2,0
154,0,264,264,444,264,180,0
155,0,337,337,481,337,144,0
156,0,233,233,569,233,336,0
157,0,334,334,553,334,219,0
158,0,289,289,380,289,91,0
159,0,360,360,354,354,0,0
160,6,236,242,332,242,90,0
161,0,324,324,337,324,13,0
162,0,220,220,339,220,119,0
163,0,309,309,318,309,9,0
164,0,200,200,318,200,118,0
165,0,278,278,336,278,58,0
166,0,172,172,286,172,114,0
167,0,265,265,265,265,0,0
168,0,161,161,288,161,127,0
169,0,254,254,261,254,7,0
170,0,154,154,237,154,83,0
171,0,244,244,266,244,22,0
172,0,142,142,205,142,63,0
173,0,236,236,170,170,0,0
174,66,126,192,167,167,0,0
175,25,152,177,134,134,0,0
176,43,151,194,128,128,0,0
177,66,115,181,119,119,0,0
178,62,108,170,129,129,0,0
179,41,101,142,85,85,0,0
180,57,113,170,90,90,0,0
181,80,67,147,63,63,0,0
182,84,76,160,59,59,0,0
183,101,50,151,59,59,0,0
184,92,47,139,55,55,0,0
185,84,49,133,65,65,0,0
186,68,46,114,62,62,0,0
187,52,57,109,68,68,0,0
188,41,57,98,78,78,0,0
189,20,68,88,86,86,0,0
190,2,85,87,126,87,39,0
191,0,95,95,164,95,69,0
192,0,112,112,177,112,65,0
193,0,130,130,187,130,57,0
194,0,137,137,284,137,147,0
195,0,144,144,300,144,156,0
196,0,194,194,275,194,81,0
197,0,186,186,246,186,60,0
198,0,199,199,293,199,94,0
199,0,174,174,317,174,143,0
200,0,209,209,271,209,62,0
201,0,192,192,320,192,128,0
202,0,200,200,377,200,177,0
203,0,206,206,423,206,217,0
204,0,239,239,441,239,202,0
205,0,256,256,365,256,109,0
206,0,271,271,387,271,116,0
207,0,235,235,368,235,133,0
208,0,266,266,378,266,112,0